تصميم	determination - design
سير	course, motion
إيجاد	discovery, finding
نافذة	window
عقب	heel
غرض	goal, purpose
حرص	desire, keenness, eagerness حرصا على - out of concern for
توفر	be plentiful, available عدم توفر - lack of
تمتع	enjoy, possess
فحسب	only, just (أريد فحسب ان اذهب هناك)
قيد	undergoing, in the process
فتنة	charm, allure (and discord)
حب	seed, grain, pill, bead
ورد	roses, flowers
ظلام	darkness, injustice
هوى	love, affection, preference على هواه - as he likes, according to his preference
إحساس	feeling
صفقة	deal, transaction
إبداع	creativity
أداة	tool
إنطلاق	start, departure
معيار	standard, criterion, norm
تناول	deal with
نقص	lack, loss, deficit
ضرر	damage, harm
زيت	oil
رائد	pioneer, explorer, leader, major
عجيب	amazing, strange
لاحق	later, next لاحقا - soon
روعة	magnificence, splendour
حقل	field
خلق	character, temperament
اخلاق	morals, ethics
منتج	product (pl. منتجات)
نال	attain, achieve
حاجز	obstacle
مورد	resource, supplies
جزى	reward, repay
ودع	let/allow (someone to do something), leave (أبتعد عن الطريق ودع الشرطة تقوم بواجبها)
توجه	attitude, approach
إجمالي	total, comprehensive
نطاق	scope, extent (تدرك مالي تماما نطاق وتعقيد التحديات الراهنة.)
معاناة	effort, hardship, suffering (e.g. of refugees)
قدر	fate, destiny
خاطر	idea, thought, mind, feeling, inclination
الخيل العلمي	science fiction
غذاء	food
فحص	examination, check-up
سعي	endeavour, pursuit
آلة	instrument, machine
ذنب	fault, offense, misdeed
كلي	complete, total, full, holistic (وينبغي تشجيعها كجزء من نهج كلي.)
مضيف -ة	host, steward
فاق	surpass, excel, wake up
قاس	harsh, cruel, severe
عناية	care, concern, attention
الطائر الطنان	hummingbird
سباق	race, competition
عجوز	old person, elderly
ود	want, like (لا, انا ود فقط الحديث)
صرح	to shout, scream
صرخة	a scream, shriek
سكك حديدية	railways
منجم الفحم	coal mine
على الأرجح	most likely
لحام	welding
ربح	gain, profit
حصة	share, quota, portion
مهني	professional, vocational
نادرا	rarely
عاجلا او آجلا	sooner or later
بحجة ان	under the pretext that
لا بأس به	not a bad... at all / quite a bit / alright هذه الأيام أظن أنه لا بأس به وانا قُمت بجهداً لا بأس به
إطلاقا من	on the basis of, proceeding from
تحل الذكرى	mark the anniversary
حل محله	replace, solve وهكذا فإن الاستعمار الأوروبي حل محله استعمار أفريقي
لا قيد أنملة	not an inch, not one iota لذا لا تتحرك قيد أنملة وإلتزم مكانك
أنملة	fingertip
عن ظهر القلب	by heart أعرف اسماء الجميع, عن ظهر قلب
بصرف النظر عن	regardless of وتتوفر خدماته للجميع بصرف النظر عن العرق
موقتا	temporarily
مسار	path, route
لوحة مفاتيح	keyboard
تنزيل	downloading
البرمجة	programming
مَنَحَ	granting, awarding
وارِد	arriving, coming, imported
الواردات	imports
رقابة	censorship, surveillance, oversight
رصيد	credit, balance, funds
تولى	take charge of
رحيل	departure, death, demise
اعرب	express, indicate
مخاطر	dangers, perils, adventures
تخلص	escape, freedom from, get rid of
حذّر	warn
إبتسامة	smile
إختبار	testing, experimenting, probing
لحق	follow, be attached to
اعجب	delight, please
توصّل	arrival, attainment, achievement
دَخْل	income, revenue
تداول	circulation, dissemination, consultation, deliberation
وفاء	loyalty, faithfulness
عسل	honey
في صدد	with regard to
في هذا الصدد	in this regard/respect
كَمَنَ	be hidden in, lie in
كَمَنَ لِ	consist of
ليت	if only, would that
عائد	interest, profit, revenue
ناتج	product, resulting from
الناتج المحلي الإجمالي	gross domestic product / GDP
شَفة	lip, rim, margin
مشاهدة	observation, inspection
أبْدى	show, demonstrate
كَفاءة	qualification, competence, talent, ability
كَفاءات	talent, talented people
نَهَضَ	rise, awaken, stand, assume
رَمْل	sand
الائتلاف	agreement, harmony in opinion
شكوى	complaint
مُفَوَّضِيَّة	commissariat, legation
خَرْق, خروق	violation, breach, infringement
وَعِيد	menace, threat
عَزْف	concert
عَزُوف عن	averse, disinclined, loath, reluctant
شريحة, شرائح	section, slice, fillet
فرز	assort, arrange, categorize, sort
من غير المعقول	it is illogical, implausible
أرْخَبيل	archipelago
حيوي	vital, lively, biological
مضاد حيوي	antibiotic
إدَّعَى	allege, claim
نزاع	conflict, struggle
حدوث	occurrence, happening
مكانة	position, standing
عجب	admiration, amazement
عُرْس	wedding
فضائي	space-, satellite-(related)
عَدا	except for
فيما عدا ذلك	apart from that
عدا عن	with the exception of
صَنْع	making, building
هزّ	shake, jolt
هزّ رأسه	to nod
شتّى	all, many, diverse
بمَثابةِ	virtually, tantamount to, kind of
خلا	be free, devoid of
تسوية	settlement, solution
إرتكب	commit, perpetrate
غابة	forest, jungle, haze, confusion
نقابة	union, syndicate
ساد	prevail, be dominant
جِلد	skin, leather
وفّر	provide st to sb, fulfill (conditions)
بالنيابة	by proxy, acting, representing
نيابةً عن	on behalf of
النيابة العامة	"prosecutor's office"
عَرْقَلَ	stop, delay, block, prevent (مذبحة في غزة.. وأميركا تعرقل تحقيقاً أممياً)
شَيّع	accompany, bid farewell to, see off (e.g. in funeral)
لقي حتفه	be killed (in action) (syn. لقى مصرعه)
الغاز المُسَيِّل للدموع	tear gas
استنشاق	inhalation, breathing in (استنشاق الغاز المسيل للدموع)
إندلع	break out
مُسَوَّدَة	sketch, draft, outline
شفاف	transparent (مجلس الأمن يدعو إلى إجراء تحقيق مستقل وشفاف)
إزاء	toward, against, versus
بما في ذلك	including
تَفَاقَم	become aggravated, worse, critical
مُتَعَمّد	deliberate, calculated, conscious, on purpose
باليستي	ballistic
آهل بالسكان	inhabited (المناطق الآهلة بالسكان)
اِعْتِراض	challenge, objection, protest, demurral
تَنَاثَرَ	be dispersed, scattered, divided into many parts (تناثر شظايا الصاروخ على الأحياء السكنية)
شَظِيّة, شظايا	fragment(s), splinter(s)
احترافية	professionalism
أحدَث	the latest
أَفْواج	In droves, en masse; regiments, battallions
عشوائيات	slums, squatter areas
سامّ	toxic, poisonous
حبس, يحبِس، الحبْس	detain, imprison, hold
المفوض السامي	High Commissioner
حرم, يحرِم	deny, deprive of, prevent s.o. from
مُمَنْهَج	systematic
تَمَخّض عن	produce, result in, bring about
مُرَوّع	appalling, dreadful, alarming
مُتَكَافِئ	balanced, proportionate, equivalent
تَبَايُن	difference, discrepancy, divergence (e.g. in proportions)
ناجم عن	caused by, arising from, a consequence of
مُنْحاز	prejudiced, biased, allied with
المواثيق الدولية	international conventions (International Law)
ضرب بعُرْض الحائط	"completely disregard, flout, reject, disdain (lit. ""hit the middle of the wall"")"
في عُرْض البحر	on the high seas
لَوْم	"blame, rebuke, reproach ""ألقى باللوم"" - to blame"
من المُرَجَّح	likely, probably
اِسْتِحْواذ	obsession, absorption, preoccupation
مُعَادَاة	hatred, hostility, aversion, jealousy
مِثْقَالَ ذَرَّة	"the weight of an atom (fig. ""in the slightest"") لن يغير الوضع على الأرض مثقال ذرة"
مُطِلٌّ عَلَى	overlooking (e.g. الجبل مطل على القرية)
زعزعة	Shake, upset
حان الوقت	the time is ripe to, it is time toالوقت قد حان الآن للتعامل مع التهديد النووي
حفرية اثرية	Archaeological excavation
غَشّ، الغِشّ	cheat, manipulate, fraud
حَفَرَ، يَحْفِرُ	dig, drill, bore, excavate
لَحْن، الحان	melody, tune
ملحّن	composer
تلحين	composition (music)
طرف، اطراف	limb, extremity, edge, border
طَرَفَ، يَطْرِفُ, الطَرْف	blink, squint, wink (لا تطرف بعينيك إلى لوحة المفاتيح)
تأهب	be alert, be prepared (تتخذ سلطنة عُمان حالة التأهب القصوى)
إعصار	hurricane, whirlwind, cyclone
هطول	precipitation, (rain)fall
غَزِير	abundant, copious, heavy (rain)
مصحوب	accompanied
عاصفة، عواصف	storm
رَعْد	thunder (thunderstorm: عاصفة رعدية)
أجّل	postpone, defer, delay
أوى	to shelter, harbour, house
إيواء	shelter, accommodation
مأوى، مآوٍ	refuge, shelter
مكتئب	depressed (psychologically)
كآبة	depression (psychological)
إنخفض	decrease
يابِس	arid, barren
تدرج في المناصب الى ان	rise in the ranks until
سافر الى امريكا في منحة دراسية	Go to America on a scholarship
في الرابع من عمره	When he was 4 years old = في سن ٤ سنوات
علامة ترقيم	Punctuation mark
فقرة	Paragraph
تلقى تعليمه	Receive one’s education
سلة	Basket
مثير	Influential, provocative
رفيع	Elevated, lofty, high-ranking
ساحل ، سواحل	Coast, seashore, beach
واقعة	Incident, event, development
محادثة	Discussion, talk, negotiation
قابل	Capable, able = قادر، قدير، موهل
مكالمة	Conversation, phone call
فعّال	Effective, active
حِذر	Care, caution, prudence
مُسْبَق	Previous, preceding
مُسْبَقا	In advance = مقدما
بَلَدي	Indigenous, native, local, folk-
تعويض، تعويضات	Compensation, restoration
مُلْتَقى	Meeting, forum, conference
صيغة	Form, shape, formula
حَظِي	Enjoy (respect, confidence), acquire
بَنْد، بُنود	Article, clause
يأس	Despair, hopelessness
بِأُسْرَتِهِ	Completely, in its entirety
إثْر	Right after
مأساة	Tragedy, calamity
جَدْوى	Benefit, advantage, utility
أسْفَل	Bottom, lower part
ناطق	Speaker, spokesman
مَعْلاة	Greatness, nobility
أسْفَر عن	Cause, result in
مَعْلَم، مَعالِم	Sign, mark, feature
مُخَدِّر	Anaesthetic
مَلاك، مَلائكة	Angel
نَصّ	Stipulate, specify
دَعْوَى	Lawsuit, legal action, allegation
صَبّ	Flow, fall (rain/snow), pour (tea)
عِصابة	Gang, band, group
جانب مُضِيء	Bright side (of things)
حلّ ب	Befall
ساق، ساقَيْن	Leg (f.)
قَدَم، قدمين	Foot
كيس نقود	Wallet
مبلغ المعاش	Pension
كواء	Iron (for clothes) الكي = ironing
خلّص من	Save from الحمد للله خلصني منه
تقلب، تقلبات	Fluctuations, vicissitudes
نَعَتَ	Describe, characterize = وصف
صَبايا	Girls
حَبْل، حِبال	Rope, cable, cord
وسيم	Beautiful, charming, pretty
لوّح	Burn, scorch, lambast
مُفْرِط	Exaggerated, excessive
سياج	Fence
تَلْبِيَةً	In response to, in compliance with
إِسْتِئناف	Resumption, renewal, reopening
-أوْعَز ل	Direct, instruct
هَتَفَ	Cheer, chant (slogans)
بَعوض	mosquito(es)
لُغْز، ألْغاز	Riddle
رغيف	Loaf of bread
شلن	5 piasters
يتيم	Orphan
هوّى	To air
إنقدح في ذهنه	Have an idea
عبقرية	Genius
قضمة	A bite
غير مستساغ	Unpalatable
بخار	Steam
شواء	Barbecue
لحم الضأن	Lamb
غمس	To dip (food)
رنّ	Resound
رُفِعَت الجلسة	The session was adjourned
قارس	Strong
بدني	Physical
ذهني	Mental
حساسية	Allergy
قُرْصة	Sting
إكتظ	Be filled with, overflow with اكتظ الشارع بمحتجين
تخصيب	Enrichment (uranium)
أَجْر، أُجور	Wage, pay, Recompense
خَلَل	Malfunction, breakdown, defect
بغَضّ النظر عن	While ignoring, turning a blind eye toغَضّ= Lowering (one’s gaze)
عِطْر، عُطور	Perfume
أَيْمَن	Right, right hand, lucky
صُلْب	adj. Solid, hard n. Core, crux, steel
مطالبة	Demand, requirement
بَعْثة	Delegation (= وفد )
نَوْعِيّة	Peculiarity, characteristic
سُرْعان ما	How quickly, it didn’t take long for
عَصَبي	Nervous, irritable
نَظيف	Clean
وَجْبة	Meal, menu
ًهُدى	Guidance
أمْسَك	Grab, hold, refrain from
مجزرة	Massacre, slaughter
تأْهيل	Certification, qualification, training
تَمْييز	Distinction, differentiation, discrimination
عِزً	Prime, peak, height
مُأَثِّر	adj. Influential, effective, touching n. effect, impact
لائحة	List, table, schedule
مُبَرّر	Excuse, justification
إلْتَفَتَ	Turn around, pay attention to
مَجاني	Free of charge
وَرْشة	Workshop
رَحِم	Uterus, womb, bosom, inside, kin, kinfolk
مُتَنَوِّع	Various, diverse, sundry
جَوْدة	Excellence, good quality
حارة	Quarter, district
سِلْعة	Commodity, product
مَطْلَع	Beginning
عَميد	Dean, chief
حَنان	Affection, love, sympathy
بَصَر	Vision، perception
قَرْض، قُروض	Bank loan
صافٍ	Pure, clear, sincere, net (econ.)
رَجاء	Hope, expectation
قارّة	Continent
سِلَع	Goods
حَريق	Fire
تَكْلِفة	Cost
مُتَكامل	Integral, comprehensive
طار، يطير، الطَيَران	Fly
طار عقله	Lose one’s mind
هو من موالِد	Be born on/in
طائر	Bird
حِدّة	Intensity, violence
بمُوجَب	According to, on the basis of
مِرْفَق، مَرافِق	Convenience, service
اشاد	Praise, commend
عامة الناس	The general public
عامةً	Generally
مُصيبة	Misfortune, tragedy
سَقْف	Roof, ceiling
تطلّع	Look/glance at, anticipate
اصّر	Insist on, assert
تَعْب	Trouble, inconvenience, burden
سور، اسوار	Fence, enclosure
مَرْتَبة	Level, rank, degree, position
دَيْن	Debt
سِنّ، اسنان	Tooth
أجْمَع	Entire, complete, all of
صَبِيّ	Young boy, youth
مُبْدِع	Innovative, creative
صَوْب	Direction, quarter
صُدور	Publication, appearance
عَرْش	Throne
مُبَيّن	Clarifying, explaining, indicating
وُدّ	Affection, fondness, friendship
ضَمير	Conscience
ميزانية	Budget
فصيلة	Faction, branch, cell
كَفّ	Palm of hand, refraining, stopping
نَقْدي	Monetary, critical
دُفْعة	Batch, class, instance
طُموح	Ambition, desire, aspiration
وَهْم	Illusion, fantasy
خَضَعَ	Submit, yield to, be subjected to, undergo
إمتداد	Extent, scope, expansion, extension
إستعادة	Recovering, regaining
مُخابرة	Correspondence, communication
مواصفات	Specification, specs
حَرْف، احراف	Letter
غاص، يغوص، الغوص	(Scuba) diving
قرنبيط	Broccoli، cauliflower
اشقر، شقراء	Blond
مغامرة	Adventure
رَكَضَ، يَرْكُض، الرَكْض	Running, jogging
حارة، حارات	Alley, lane
ناصية، نواصٍ	Corner (of an intersection)
نفق، انفاق	Tunnel
عمارة، عمارات	Building
عقار، عقارات	Real estate
مقصف، مقاصف	Cafe
حانة، حانات	Bar (for drinks)
مسرح، مسارح	Theater
مقعد، مقاعد	Seat, bench
كنيس	Synagogue
طوب	Brick
صرّاف آلي	ATM
عيادة، عيادات	Clinic
ينبوع، ينابيع	Fountain
رصيف	Sidewalk
مَطَبّ، مطبات	Pothole, speed bump
بلاعة، بلاعات	Sewer, drain
مجاري	Sewage
يافطة، يافطات	Sign (traffic)
مواصلات	Transportation
مرور	Traffic
ضَجّة	Noise
هَرْجَلة	Mess
نُفاية	Trash, garbage
طابور، طوابير	Queue, line of people
حافلة، حوافل	Bus
دَرّاجة	Bicycle
شاحنة	Truck
عجلة القيادة	Steering wheel
فرامَل	Brakes
زَمّر	Honk
بَوْق، ابواق	Car horn
صادَمَ	To Crash
مَرْكَب	Boat
زَوْرَق، زوارق	Boat
قارِب، قوارب	Small boat
سفينة	Ship
عَبّارة، عبارات	(Cruise) liner (large ship)
أقْلَعَ	Take off (plane)
هَبَطَ، يَهْبُطُ، هُبوط	To land (plane)
حَجَز، يَحْجِزُ، حَجز	To reserve
تعَطّل	Be delayed
نَسَمة، نسمات	Person (in statistics)
طِفْل رَضيع، اطفال رضاع	Baby
صَبي، صِبْيان	Boy
نَجْل، اَنْجال	Son (=ابن)
صَبية، صبايا	Girl
عَيِّل، عِيَّال	Kid
مُراهق	Teenager, adolescent
فَتى، فِتيان	Young man
قاصِر	Minor (opp. بالغ)
راشد	Adult (=بالغ)
تَؤْام، توائم	Twin
يتيم، يتامى	Orphan
جَدّ، جُدود	Grandfather
نَسيب، انْسِباء	In-law
حَماه، احْماء	Father in law
حَماة، حموات	Mother in law
صِهر، اصهار	Son in law
كَنّة، كَنائن	Daughter in law
سِلف، اسلاف	Brother in law (spouse’s brother)
عديل، عدائل	Brother in law (sibling’s husband)
سِلفة	Sister in law
اَعْزَب	Single, unmarried
نِكاح	Marriage
ليلة الدُخْلة	Wedding night
شَهْر عَسَل	Honeymoon
مَهْر، مُهور	Dowry (=صِداق)
عَروس، عرائس	Bride
عريس	Groom
اَنْجَبَ	Have children
مُطَلَّق	Ex-husband (مطلقة=exwife)
ارمل، ارامل	Widower (ارملة=widow)
كراهية	Hate
حَنين	Yearning
شَوْق	Longing, desire
مَرارة	Bitterness
صَرَخَ يَصْرُخ، الصُراخ	Scream, shout
شَتَمَ، يَشْتِم، الشَتم	To insult
خانَقَ	To fight with s.o.
جادَلَ	Argue with s.o.
لامَ، يَلوم، اللوم على	Blame so for st
أنّبَ على	Scold so for st
بَوّزَ	Pout, sulk
تَجَهَّمَ	Frown, scowl
ناصِر، انصار	Partisan, supporter
اِطّلع	Review, examine, study, peruse
إضطراب	Disturbance, disorder
صَلُحَ	Be suitable, fitting, valid
بيئيّ	Environmental
تَوافُق	Congruence, compatibility, agreement
اَحْسَنَ	Master, be good at
شَوْط	Round, phase, game, half period
قَطَعَ شَوْطا	Make headway, major progress
صِيانة	Maintenance, preservation
اقَرّ	Ratify, accept, confess st
استطلاع	Poll, investigation, reconnaissance
سائر	Most of, the majority of
ميناء	Port, harbour
شكى، يشكو، الشكوى من	Complain about
تَذَمَّرَ	Grumble, complain (about)
إنفضح	Be disgraced, be subject of a scandal
جُرْسة	Public disgrace, scandal
قَبَّلَ	To kiss
قُبْلة، قُبْلات	A kiss
حَضَنَ، يَحْضُنُ، الحُضْن	Hug, embrace
تَنَهَّدَ	To sigh
تَنْهيدة، تَناهيد	A sigh
مَرِح	Cheerful
فَخور	Proud (فَخْر=pride)
راضي	Content, satisfied
رَضِىَ، يَرْضَى، رِضىً	Be content, satisfied with
نادِم	Regretful (نَدَم=regret)
نَدَمَ، يَنْدَمُ، النَدَم	To regret
تَعيس، تُعَساء	Miserable, very unhappy
أُمْنِية، امانٍ	A hope, wish
إستكان، يستكين، الاستكانة	Resign oneself to
تَعَوَّد	Get used to
قَلِقَ، يَقْلِقُ، القَلَق	Be worried
هَمّ، هُموم	Worries
تَضايق من	Get annoyed at
مُتَضايِق	Annoyed
مُشاغِب	Troublemaker
خَجِلَ، يَخْجَلُ، الخَجَل من	Be embarrassed by
خَجْلان	Embarrassed
أَخْجَلَ	To embarrass so (=أحْرَجَ)
أَحْرَجَ	Embarrass (=أَخْجَلَ)
خَجول	Shy, embarrassed
حَساس	Sensitive
مُشَجِّع	Supporter, fan (eg football)
دَهَسَ, يَدْهَسُ، الدَهْس	Run over, trample down, crush
نُعَاس	Sleepiness, drowsiness غلبه النعاس= he fell asleep, became drowsy
مارة	Passing, passers by, bystanders
حَشْد، حُشود	Crowd, mobilization
حَرِج	Narrow, tight, oppressed, critical (eg situation, injuries)
سُلَحْفاة، سَلاحِف	Turtle
اكتظاظ	Overcrowding
إنتقم	Take revenge, avenge (Revenge = إنتقام)
جوز	Walnut
العَذْراء	The Virgin
شَنَب	Moustache (وَحَياة شَنَبي = I swear by my moustache)
مَيْل، مُيول	Tendency, inclination
شَقي، اشقياء	Naughty, mischievous
مُتَهَوِّر	Reckless
طَمْأَنَ، يُطَمْئِنُ، الطَمْأنة	To reassure s.o.
مُنْدَهِش	Amazed
أَدْهَشَ	To amaze
مُسْتَغْرِب	Astonished, surprised
مَذْهول	Shocked
حائِر	Confused (حيرة= confusion)
حَيَّرَ	To confuse s.o.
حازِم	Firm
حاسِم	Decisive
أَفْزَعَ	To frighten, alarm s.o.
ذُعْر	Panic, terror
غَيور، غُيُر	Jealous (Jealousy = غيرة)
غار، يَغيرُ، الغيرة	Be jealous (of)
حَسود، حُسُد	Envious (Envy = حَسَد)
حَسَدَ، يَحْسُدُ، الحَسَد	To envy
مُشْمَئِزّ من	Disgusted by
إشْمَأزَّ، يَشْمَأِزُّ، الإشْمِئزاز	To be disgusted
واثِق ب	Confident in
نَعْسان	Sleepy
عَنيد، عُنُد	Stubborn
طَمّاع	Greedy
فَجْعان	Gluttonous
أناني	Selfish (Opp. غيري)
مُسْرِف	Spendthrift
بَخيل	Stingy, cheap
مُقْتَصِد	Frugal
مُهْمِل	Careless, negligent
حَنون	Affectionate (Affection = حنان(
شَفوق	Kind (= طَيِّب)
ظَريف، ظُرَفاء	Pleasant, agreeable (Pleasantness = الظَرْف)
حَليم، حُلَماء	Tolerant, good-natured
رَقيق، رُقاق	Gentle, sensitive
مُؤَدَّب	Polite
كَسول	Lazy (Opp. مُجْتَهِد)
مُصَمّم	Determined
فائِق	Alert, awake
جَرِئ	Bold, daring (Rel. to شُجاع)
جَبان، جُبَناء	Cowardly (adj)
فُضولي	Curious
مَغْرور	Egotistical, conceited
تَباهى، يَتَباهي، تَباهٍ ب	Brag, boast about
عاقِل، عُقَلاء	Sensitive, reasonable, sane
أَهْبَل، هَبْلاء، هُبْل	Silly, foolish, simple-minded
سَخيف، سُخَفاء	Stupid, fatuous; disagreeable, nasty
شاطِر، شاطِرون	Clever
نَبيه، نُبَهاء	Smart, intelligent
نَزيه، نُزَهاء	Honest, scrupulous, has integrity
غَدّار	Treacherous, betrayer
غَدَرَ، يَغْدُرُ، الغَدْر ب	Betray (= خان، يجون، الجيانة)
نَصَّاب	Swindler
مَكّار	Cunning, sly, deceitful
خَدَعَ، يَخْدَعُ، الخُدْعة	To trick, deceive
قاسٍ، قُساة	Cruel (Cruelty = القَسوة)
قَسا، يَقْسو، القَسْوة على	To be cruel to
ساذِج، سُذّاج	Naive, clueless
مُتَفائل	Optimistic (Opp. مُتَشائم)
مُتَشائم	Pessimistic (Opp. مُتَفائل)
مُضَحِّك	Funny
عاطِف، عَواطِف	Emotion
مَهْموم	Worried
مُتَوَتّر	Tense, nervous
أَزْعَجَ	To annoy
وُلوج	Access, entry
قائض	Excess, surplus
مقايضة	Barter, trade-off, exchange
استيراد	Importation
نُحاس	Copper
راقي	Advanced, classy
وَدي، وديان	Valley
رَي	Irrigation (مرَوّي = irrigated)
إخْتِراع	Invention
طَوْر، اطوار	Stage, phase
ملكية	Ownership
تلاشى	Fade, disappear
تضاءل	Diminish, erode
مَحاصيل	Crops, yields
سفن شراعية	Sailing ships
استعاض	Replace, substitute
ثَوْر	Bull, ox (ثيران)
جَرّ	Drag, pull
حَرَثَ، يْحرَثُ، الحَرْث	Plough, till
زَحَفَ، يَزْحَفُ، الزَحْف	Crawl, creep
زَحافة	Reptile
إبتكر	Invent, come up with
بِكْر	Virgin
طَقْس، طُقوس	Ritual
فُخار	Pottery
لَبَثَ، يَلْبَثُ، اللَبْث/اللِباث	Tarry, linger Not take long, lose no time
سَخّرَ	Make use of
تَفاعُلي	Interactive
إندِفاع	Rush, momentum
بُزوغ	Emergence, dawn
جَوْهَري	Fundamental, essential
إبان	During
ثمة	There is
خام	Raw, crude المواد الخام= raw material
تَعْدين	Mining
دَعامة	Pillar, cornerstone
شَرَعَ	Initiate, begin
تَراكَمي	Cumulative, incremental
وفرة	Abundance
مُطير	Rainy
مَناخ	Climate, atmosphere مناخي - climatic
رُقْعة	Patch, area
دِجْلة	Tigris
تَجانُس	Cohesion, homogenization
ساذِج	Simple, naive
بالاَحْرى	Rather, instead
بؤرة	Focus, epicenter, focal point
انعِزال	Isolation
مُقَوَّمات	Fundamentals, features, viability
فَخْم	Stately, grandiose, splendid
مَضْفور	Intertwined, braided
لِبْن	Brick
أسطواني	Cylindrical
بواكير	Early, in beginning of
تَشييد	Construction, building
مصطبة	Terrace
شُيوع	Prevalence, spread
دمى	Effigies, puppets
تَشْخيص	Diagnosis
مِسماري	Cuneiform
قالِب، قَوالِب	Stereotype, mould, template
لوح، الواح	Tablet, board
تجنى ضرائب	Levy taxes
إلَه، آلِهة	Deity, god
عَصَب	Nerve
تَرْف	Luxury
قشرة	Peel, skin, crust, veneer
فأس	Axe
إنْبَثَقَ	Emanate from, spring from
سُلالة	Dynasty
مُبْهِم	Vague, ambiguous
تَناسُق	Coherence, harmony
فَجْوة	Gap, hole
مُغأير	Different
إنبِلاج	Dawn
تَوطيد	Consolidation
موازٍ، الموازي	Parallel
هَرَمي	Hierarchical (From هَرَم، اهْرام)
وَخيم	Grave, dire
عَلاوةً على	In addition to, moreover
بَسَطَ السيطرة	Excert authority
مساواة	Equality
متساوي	Equal (Better: على قدم المساواة؛ على مبدأ المساواة)
إنتهازية	Opportunism (Adj: إنتهازي)
عضو، اعضاء	Organ (of the body), member
وَرَم، اورام	Tumour
بَخور	Incense
جَلَبَ، يَجْلِبُ، الجَلْب	Bring, import
شائِع	Common, popular
إقْتَبَسَ	To quote (A quote: اقتباس)
مِحْرَاب، مَحارِيب	Niche (architecture)
نَصْب	Cheating, swindling
تَذكاري	Commemorative, memorial
مَزْهَرية	Vase (for flowers)
عاج	Ivory (Adj. عاجي)
كان حَري بي ان	I should have
رَقَبَة	Neck
تَغَلَّبَ على	Overcome, defeat
مُفْتَرِس	Predator, predatory, ferocious
عَزَا، يَعْزو، العَزْو	Ascribe
أتْكَلَ على	Rely on (إتْكال = reliance)
إغْفال	Carelessness, absentmindedness, disregard
نَهِلَ، يَنْهَل، النَهَل	To drink
قَفَزَ، يَقْفِز، القَفْز	To jump
عَيَّط	Cry, weep (عِياط = yelling, screaming)
نَقْش، نُقُوش	Inscription
دَيْر، أديرة	Monastery
نَسَل	Lineage
نَحْل	False attribution (early poetry) - مَنْحول Bee(s)
ناقة, نُوق	Female camel
مُولَع ب	Crazy about, enthusiast, deeply attracted to
قافية	Rhyme
أطْلال	Ruins, remains
نَسَجَ، يَنْسُجُ، النَسْج	To weave, knit
فات، يَفوت الفَوْت	Elude, pass by فاته ان = it escaped him that, he missed
سال، يَسيلُ، السَيل	Flow, run, stream
سؤال إخباري	Rhetorical question
دَأَبَ، يَدْأَبَ، الدَأْب	Persist, persevere
دَأب، أدْؤُب	Habit
نَحَرَ، يَنْحُر، النَحْر	Slaughter
نَحْر	Throat, killing/slaughter
دِهْن	Fat
هَدَب	Lashes, fringes
نَحْت	Sculpting
أَتْلَفَ	Discard, scrap, destroy
فَلَك	Astrology
الذَكاء الصناعي	Artificial intelligence
جَنّة، جَنائِن	Garden
حجر الرشيد	Rosetta Stone
تَأَهُّل	Qualification (incl. for competitions)
رَوّاج	Vogue, popularity, boom
طَعَنَ، يَطْعُن، الطَعْن	Stab, appeal (verdict)
سَطْوة	Reign, power
جِوار	Vicinity
إضرام	Ignite (fire), set alight
فلاة	Desert
بَلَغَ السَيْل الزَبي	Have enough of
أَنَفة	Pride, haughtiness
طيش	Indiscretion, recklessness
مَنْفَذ	Opening, exit, access
إلحاح	Urgency, pressing
إِبِل	Camels
فَصيل	Young camel
إستِفْزاز	Provocation
على سَكَرات الموت	in agony of death, in death throes
مَظْلوم	Wronged, aggrieved
كَشَحَ	Harbour enmity toward
مُكَبَّس	Stapler (Staples: كبّاسات)
غُراب، غِرْبان/أغْرِبة	Crow
زير، أزيار	Ladies’ man, philanderer
أنام	Living creatures, people
مُجون	Buffoonery
فَحْل	Stallion, bull, virile, strong poet
فُحولة	Potency, virility
هَلْهَل	Flimsy, loose
هَلَلْ	Dread, fright, terror
هَلَّلَ	Glorify, praise
تَوَغَّلَ	Go deep into, advance, delve into
سَريع البَديهة	Quick-witted, fast on one’s foot
رُمْح، رِماح	Spear
خِصال	Characteristics (Syn. سِفات)
شَمَّرَ	Pull up (sleeve or trouser leg; latter is signal of serious event)
عار	Shame
مَلْحَمة	Epic
أجْهَزَ على	Kill
ثأر على	Blood revenge
حيلة	Trick, ruse
وأد	Burying alive (eg of baby girls)
سَبي، سَبايا	Prisoner of war
دَعَارة	Prostitution (Syn. بِغاء، خَلاعة، فُجور، فِسق)
نُزوح	Displacement, migration, exodus (نازحون: displaced people)
مُبْرَم	Firm, definitely established, binding
فئة, فئات	Category
تَفاوُت	(Statistical) variation (Also: اختلافات، مُتَغَيِّر، فُروق)
احتياط	Reserve, backup, precaution
فرضية	Hypothesis (Also افتراض)
توسُع	Expansion (Transitive: توسيع)
ثَعْلَب, ثَعَالِب	Fox
شَحْم	fat (noun)
طَبْل، طبول	Drum
قُضْبان	Branches/sticks (of a tree)
مُفْرِه	Fancy, elegant
اناقة	Stylishness, Chic-ness
كادِح	Hard-working
انهيار	Collapse
خَروف، خِراف	Lamb
خُرافة	Myth, superstition
تَماهي	Alignment, identification with
بَخْض التصعيد	De-escalation
إنْضَمّ إلى	Join
خاتِم، خواتِم	Ring
خَلّْ	Vinegar
الجدري	Smallpox
أَضْحى, يضحو	To become
أَمسى	To become
فكاهة	Comedy
نوعية	Quality
وَعاء	Bowl
إنتمى الى	Belong to, be related to
اثرى	Enrich
نَدْرة	Scarcity
عُشْب	Lawn, grass
أَلِفَ	Be familiar with
قياس	Measure, measuring
مِقدار	Amount, quantity, degree
تطلّب	Require
استعباد	Slavery, enslavement
عَبَثا / عابِثا	In vain
بَغْتَةً / مُباغِتا	Suddenly, surprisingly
زَرافاتٍ	In groups
وَحْدَهُ / وَحدَها	On its own, alone
وَجْهاً لِوَجْهٍ	Face to face
قُبْعة	Hat
شرعية	Legitimacy
قضية، قضايا	Cause
إغْواء / -ات	Temptation
تجَنَّب	To avoid
مُنضَبِط	Disciplined
تدبّر	Manage, handle, sort out
تنمّر	Mobbing
قُـرصان، قَراصِن	Pirate
درب/دروب الذكريات	Memory lane
خَسارة، خسائر	Loss (Rel فقدان، هزيمة)
مَلْعون	Cursed, damned, bloody, goddamn (From لَعَنَ، يَلْعَنُ، اللَعْن، to curse)
شعوذة	Sorcery, witchcraft
أُفُق، آفاق	Horizon, prospect
خَنَقَ، يَخْنُقُ، الخَنْق	Strangle, suffocate, stifle
حُكْر على	Limited to, exclusively reserved for, monopolized by
طَرَّزَ	To Embroider
طَرْز، طُروز	Type, model, make, brand (Also طِراز، طُرُز/اطْرِزة)
أطْرَش، طرشاء، طرش	Deaf
أخْرَس، خرساء، خرس	Mute
أَعْمَى، عَمياء، عُمُى/عُميان	Blind
عِجْل، عُجول/عَجَلة	Calf
مؤسسة غير ربحية	Non-profit (foundation/organization)
دليل	Guide
دَرْب/ دَرْبات الجَزاء	Penalty (football)
رمية	A throw (Football: رمية تماس، رمية جانبية)
الاجهاض	Abortion
ميزة	Advantage
تصدى	Save, stop (eg keeper in football)
دربات الترجيح	Penalty shootout (Also ركلات الترجيح)
رِكْلة، -ات	Kick
امر مبتذل	Cliche
تسريب	A leak
قياسي	Record (adj) (وقت قياسي، عدد قياسي)
أَحْرَزَ	"Obtain, achieve, keep ( يأمل من خلالها أن ""يُحرز تقدما لاحتواء هذه الأزمة)"
رُبْع النهائي	Quarter final
على ما يرام	As well as one could wish Fine, all right, ok
غيث	Rain
كَلَأ، أكلاء	Grass, pasture
تَسَرَّبَ	Leak, flow, infiltrate
دَثَرَ، يَدْثُرُ، الدُثُور	Be obliterated (Syn: إندثر)
تدبير	Planning, organization, management
صِهْرِيج، صَهاريج	Cistern, large container
أُسطول، أساطيل	Fleet, squadron
ضَهَدَ، يَضْهَدُ، الضَهْد	Oppress, persecute
غَلْغَلَ	Penetrate, insert
تغلغل	Go quickly, get far, enter
لا يَمُتّ بِصِلة	Bears no link to
عَصا، عُصِيّ	Stick, staff, rod
عالِق	Stuck, trapped
مَغمور	Submerged, immersed, submarine
الفيضان	Flood
حافة	Edge, verge, brink, ledge
على أَحرَّ من الجَمْر	On pins and needles, waiting anxiously (جمر = embers, live coal)
باحة	Yard, court, lot
فناء	Courtyard
المعتنى به	Taken care of, well-kept
إعتناء	Taking care of, looking after
سَحَقَ، يَسْحَقُ، السَحْق	Annihilate, crush
غَرَزَ، يَغْرِزُ، الغَرْز	Insert, stick, plant
إستأصل	Root out, exterminate, annihilate
أَفْعىً، أَفاعٍ	Viper, snake
خُبْث	Wickedness, malignancy
دُهاء	Smartness, slyness, cunning
مَهَلَ، يَمْهَلَ، المَهْل	Tarry, take one’s time (امهل = give someone time)
دَرْبة حُرّة	Free kick
رَيْب	Doubt (لا ريب فيه، بلا ريب)
زِمام، أَزِمّة	Rein, nose rope (بِزِمامِهِ = under his supervision)
رُكام	Pile, heap, clouds
تعمير	Construction
أكْذوبة	A lie
قَصّاص	Storyteller
أدْجَلة	Ideologization
خَصْم، خُصوم	Opponent, adversary
إسراف	Extravagance, exaggeration
أضْمَرَ	Hide, conceal
أتْقَنَ	Perfect, master, know well
مُرادِف	Synonym
تَضاد	The opposite of (ما هو تضاد كلمة ااا)
خَرَبَ، يَخْرِبُ، الخَرْب/الخِراب	Destroy, ruin
خِرْبة	Ruins
خُرْبة	Hole
لَحْن، ألْحان	Grammatical mistake; melody
وَسَخ، اوساخ	Dirt, filth
ضَئيل	Tiny
ذُيوع	Spread, dispersion
مَهْجَر	Diaspora (Syn. شَتات)
ذاع، يَذيع، الذُيوع	To spread
إرتشاف	Sipping, drinking
أفاويق	Milk, benefactions, kindness
عَطَسَ، يَعْطِسُ، العُطاس	Sneaze
سَرَدَ، يَسْرُدُ، السَرْد	Pierce, continue, tell, narrate
قِمار	Gambling (Syn. مَيْسِر - [name of game])
مَيْسَرَة	Prosperity, wealth
قَحْط	Drought, famine
قَبيح	Ugly, repulsive
إمْلاق	Poverty
تَبَرُّح	Making oneself pretty (women)
كَسى، يَكْسى، الكسى	To dress, clothe
فاحِشة، فَواحِش	Fornication, prostitution, promiscuity
سَلْب	Plundering, robbing
نَهْب	Robbery, plundering
تَفِه	Trivial, small
منصوب	Raised, erected
نَصَبَ، يَنْصُبُ، النَصْب	Raise, erect
مَتَّنَ	Strengthen, make firm
قِرىً الضيف	Hospitality
نَكَثَ، يَنْكُثُ، النَكْث	Breach, violate
خَفَرَ، يَخْفُرُ، الخَفْر/الخِفارة	Watch, guard, protect
خَفِر	Shy
جَنابة	Major ritual impurity
مُداومة	Perseverance
دربة ركنية	Corner (football)
لَعْنة	Curse
إستنجاء	Delivery, escape, being saved
قلّم	Clip, trim (eg nails)
أُظفور، أظافِر	Nail
نَتْف	Plucking, tearing out (eg hair)
تَهَيَّأَ	Be prepared for
هَيَّأَ	To prepare
خَليل	Friend (Also epithet of Abraham)
قِدْح، اقداح	Arrow used for devining
مَنْكِب، مَناكِب	Shoulder, side, flank (Topographic: highland, upland)
لُقْمة، لُقَم	Bite, mouthful, tidbit
إنصرف	Leave, abandon, be spent (money)
أغْدَقَ	Give bountifully, bestow liberally, shower
غَديق	Copious, abundant
طاق، يطوق، الطوق	Be able/capable, be in a position to, bear
جَنِين، أَجِنّة	Fetus, embryo
غَمُرَ، يَغْمُرُ، الغَمارة	Be plentiful, abundant
هَشّ	Fragile, brittle (Syn. هَشاش)
بقاء	Survival
فَرش، فُروش	Furnishing, household effects
صَوْمَعَة، صَوَامِع	Monk’s cell, hermitage
راهِب، رَبهان	Monk
غَمَّ، يَغُمُّ، الغَمّ	To cover, conceal; to pain, distress
جَذَبَ	Pull, draw
ضَمّ	Bring together
إعْتَصَمَ	Cling, adhere
قَذَر، اقذار	Impurity, uncleanliness
عَوْرة	Deficiency
عَوْرات	Genitals
أَزار، أُزُر	Loincloth, cover
دِيّة	Blood money
فَضْل، فُضول	Surplus, excess, waste
بَريق	Glitter, shine
بَديع	Wonderful, unique
بِضاعة، بَضائع	Goods, merchandise
حيرة	Confusion
وَهَبَ	Give, grant
حَرير	Silk
اَوْشَكَ على	Be on the verge of, be about to (Rel. على وِشْك أن)
جارِف	Torrential, stormy, violent
إضْطَرَّ	Force, compel, coerce
فَلَقَ، يَفْلِقُ، الفَلْق	Split, cleave, tear asunder
عَضَّ, يُعَضّ، العض	To bite
رُفات	Remains
حَوْزة	Possession, custody
حافِل ب	Full of, replete with تاريخ حافل ب = a long history of
قَطَفَ	To pick (eg flowers)
قَطَّرَ	To distil
قَوْس قُزَح	Rainbow
انفعالي	Emotional, sentimental
تفطّن	Realise, figure out
منعرج	Critical juncture, crossroads, turning point
ناموس، نواميس	Law, honour, cunning
وَسَمَ	To brand, mark
تَوَسَّمَ	Scrutinize, watch closely
جَهَرَ، يَجْهَرُ، الجَهْر	Appear, declare publicly
صَدَعَ، يَصْدَع، الصَدْع	Crack, break (st) (متصدِّع = fragile)
ابْطَح	Flat, level
رَمْضاء	Sun-baked ground
حَرْبَة، حِراب	Lance
عِفة	Abstinence, virtue, honesty
تَنكيل	Desecration (of bodies)
لَوّى	Bend, twist (تلوية)
ذراري	Women
حِصْن، حُصُون	Fortress
صياغة	Crafting, craftsmanship, wording
نَفَقَة	Expense, cost
نقمة	Curse
نَبْل، نِبال	Arrow
شَطَرَ	To cut/sever, be clever
اَجْلى	Expel
نَدَبَ	Appoint, commission, entrust
سَفَح	Summit, top
مِعْوَل، مَعَاوِل	Pickax
مَكيدة، مَكائد	Ruse, deception
جَزِعَ	Be anxious, worried
غَليظ	Thick, solid, crude
طَمَعَ	To covet, desire
طَمْع، اطْماع	Greed, desire
نَقْض	Breaking, violating (treaty)
مناوشة	Skirmish
نَخيل / نَخل	Palms, date palms
ذِمّة	Protection
أداء	Performance, execution (of rituals) (Syn تأدية)
ادّى	Perform, carry out, cause
اِراقة	Shedding, spilling
تَخاذَب	Contend w one another, pull back & forth
إتاحة	Providing, giving
سَرَى، يُسْري، سري	Set out, flow spread
اقتدى	Emulate, imitate
نَصيب، انصباء	Share, participation, luck, fate
هَيْبة	Prestige, dignity
أذى	Harm, hurt
تربّص	To stalk
شَوكة	Power, might (and fork)
تنازل	Concede, make concession
إقتطاع	Deduction, reduction
صَنيع	Action, act, deed
إجحاف	Inequity, unfairness
ثاقِب	Penetrating, insightful
جَوْر	Injustice, tyranny
دَنِيّة	Disgrace, infamy
مَنْعة	Resistance, power, force
مُدَرَّع	Armoured
تَعُون	Plague, pest
سادِن	Servant
ميمنة	Right side
ميسرة	Left side
بَغْلة	Female donkey
طَليق	Free, fluent
وَبّخَ	Scold, reprimand
بَلْبَلة	Chaos, mess
مَعْشَر	Crowd, people
مُفارقة	Paradox
استخفاف	Dismiss, not take seriously
باسل	Strong (n. بسالة)
سَكّ	Brandish (sword), take out of sheath
غِمْد	Sheath
بأس	Strength, courage
بَطْش	Strength, force, oppression
حسب حسابا ل	Be afraid of
باغت	To surprise
شَحَذَ	Hone, strengthen (also: ask for alms)
شَحّاذ	Beggar
جِدْرية	Graffiti
ضَريح، أضْرِحة	Mausoleum
زائد	Plus
ناقِص	Minus
مَرْمى حَجَر	Stone’s throw
وَتَخَلَّل	During
هَدِى	Sacrifices
دابة	Steed, hoofed animal
حافِر	Hoof, clove
حُفّ	Camel’s hoof
رُجْحان	Preponderance (eg of evidence)
تأمّل	Contemplate, reflect, look attentively at
أبْلى	Do well in
استحوذ على	Overwhelm, overpower, seize
فَزْع	Fear, fright
ميثار	Inheritance, heritage, legacy
مُتَجَانِف ل	Inclined toward
مُتَوَرِّط	Involved, entangled in
مُتَصَدِّع	Fragile, brittle, full of cracks
حَطَل	Idle talk
لَفْظي	Verbal, oral
أخَلّ	Violate, fail to fulfil
استنتج	Infer, conclude
إمْتِصاص	Absorption
مُرونة	Flexibility
اكتسى	To Cover
زَوبَعَة	Storm, hurricane
حُمّى	Fever
مَشَقّة	Hardship, trouble
ضَنْك	Poverty, distress
عُسْرة	Hardship
شَحيح	Stingy, scarce, meager
قَتّات	Slanderer
عَجَنَ	To knead
عَجينة	Dough
عجين	Batter, paste, pasta
فَضَحَ	Disclose, uncover
هَرَقَ	Pour out
مُراهَنة	Bet, wager
رَهينة، رَهائن	Hostage
قَرَصَ	Pinch, sting
خَلّفَ	Produce a child (Syn انجب)
شيخوخة	Old age
تلقيح	Inoculation, vaccination (التلقيح الصناعي = artificial insemination)
حلّق	Fly, soar
خَشِن، خِشان	Coarse, crude, (masculine)
تَفاهة	Nonsense, silly talk
مَزَحَ	To joke
لان، يلين، اللين	Be(come) soft (لَيَّن = to soften)
كياسة	Courtesy
غَرَسَ	Instil, inculcate
شُغَف	Passion
علّل	Justify, explain (Also: occupy, keep busy)
اذعن	Give in, yield, concede, declare
جَسيم	Serious, gross, major
نشوة	Euphoria, trance, elation
قَطَن، يَقْطُنُ، القُطُون	Reside, dwell, live
ساحرة	Witch
رَقْمي	Digital (الفضاء الرقمي = digital space)
توّج	To crown
تاج، تيجان	Crown
نَبَشَ، يَنْبُشُ، النَبْش	Exhume, dig up (E.g Corpse, grave)
تقلّص	Diminish, contract, erode
وَرْطة	Plight, trouble, predicament, quagmire
إحْجام	Reluctance reticence
تطرّق الى	Touch upon, raise (issue)
تسلية	Fun, entertainment
مَجْهول	Anonymous
صاري، صواري	Mast
ريثما	Until
زَجّ، يَزُجّ، الزَجّ	Throw, push, squeeze زُجَّ به في السجن = be thrown into prison
تأويل	Interpretation
خانة	Box, category, column
تحريف	Distortion
إسْتَلَم	Receive, get
سُتْرة	Jacket, vest
صارم	Strict
دَهانة	Paint
دَرء	Warding off, prevention
تَسْيير	Conduct, management
اخْضَع	Subdue, subjugate
مَشَّطَ	To comb
شَنيع	Ugly, repulsive
لان، يَلين، اللين	Be soft
لَيَّنَ	To soften
أَبَى	Refuse
أَقْبَلَ	To come
فاقد الواعي	Unconscious
مُغْشي	Unconscious
خُرافي	Mythical (Rel. وهمي)
تَحَرَّجَ	Be sorry, embarrassed
مُحْرِج	Sorry, embarrassed
مَرِن	Flexible
أنْصَفَ	Be objective (إنصاف = objectivity)
خَنْجَر	Dagger
مُتَفاعِل	Cooperative
مُباح	Allowed, permissible
أفُلَ، يَأْفِلُ، الافول	Decline, sink (افل نجمه)
عَبّى	To fill
صَليل	Sound of sword
مَفْعول	Effect (Rel تاثير)
يَافِع	Young
إيهام	Deceiving, deception
بُرْقَع، بَراقع	Burqa
حِسان، أحْسِنة	Horse
فِيل، فِيَلَة	Elephant
تَرَوِّي	Caution, prudence
مَدَحَ	To compliment, praise
اثنى على	To praise
اثنى عن	To prevent
ثُغور	Periphery
ارض السَوَّاد	Iraq
إمداد -ات	Reinforcement
حَذَفَ	Delete, remove
إراحة	Move, displace
زُمُرُّد	Emerald
نُفوذ	Influence
استفحل	Increase, deepen, worsen
مُشَرّد	Displaced, homeless (person)
شَرَّدَ	Displace
عبودية	Slavery
سياط / سوط	Whip
افضلية	Preference
رَماد	Ash
رَؤوف	Merciful (From رأف = show pity)
سَخى، يسخي، السَخاء	Generosity
قَسَم، اقسام	Oath (قَسْما ب - I swear)
عسّ	Patrolling by night
رَعْية، رَعايا	Subjects, citizens
فِراسة	Acumen, intuition
زَيَّف	To fake (مزيف = fake)
تَهافُت	Inconsistency
مارِق	Apostate, deserter
مَيَّزَ	To discriminate
مَظَلّة	Umbrella
تَبَخَّرَ	Evaporate
لِثَام	Veil (Half of face). مُلَثّم
كَساد	Economic depression
وَجَلَ	Fear greatly
مِثالي	Idealist (n), ideal, idealistic (a)
كِهانة	Metaphor
طَمَسَ	Erase
قُدْوة	Model, exemplar
تَجْريدي	Abstract
وَعْكة	Illness
خِمار	Face veil/cover
اصالة	Authenticity
زَغروتة	Zaghruteh
نَكْد، انكاد	Misfortune
كَشَّرَ	Smile, grin (bare teeth)
حَطَب/احطاب	Firewood
مُنْهَمِك	Engrossed, absorbed
تَفَكُّك	Fragmentation, breakup
فَكَّ	To disconnect
علامات التنصيص	Quotation marks
فَلتة	Unexpected event
لَغَطَ	Be noisy, shout
زُبْدة	Essence/gist, butter
مختبر	Lab
ريشة، ريش	Feather
جسامة	Volume, size
مَسَحَ	Erase
سِتار، سُتُر	Veil, curtain
إقصائي	Exclusionary غير اقصائي = inclusive
هالة	Halo, aura (محاط بهالة)
وَصْم	Stigmatization
اضطهادات	Persecution
تساهل	Leniency, tolerance
فضلا عن	In addition to, moreover
ناجم عن	Caused by
مَهارات	Skills
جاذب	Attractive
كَبَحَ، يَكْبَح، الكَبح	Rein in, curb, restrain
استرداد	Recovery, restitution, reimbursement
مرتزقة	Mercenaries (مرتزق)
افسح المجال ل	Make room for
خطيئة، خطايا	Sin
متاخم ل	Adjacent to
جحافل	Hordes
باءَ	To fail
حصين	Immune, impregnable
حوض	Basin
قلعة، قلاع	Castle
اقتراع	Polling, voting
وَقِح	Rude, shameless
جازَفَ	To risk, dare
اجتاح	Invade
اِسْتَوْلى على	Take control of
إلْتَحَمَ	To clash, confront one another
تَضَعْضَعَ	Retreat (from battle)
مُناوَرة	Skirmish
زَحْزَحَ	Advance (troops)
إحتمى	Be protected, find protection
على التوالي	Continuously
إلْهام	Inspiration
تِكرار	Repetition
انتعاش	Revival
معزول	Isolated
استرخى	Relax
شَمَعَة، شمع/شُموع	Candle
سُلَّم	Ladder
شذوذ	Anomaly, abnormality
جَنَحَ	Lean toward, deviate
زَخْم	Momentum
مِحْوَري	Pivotal
طَفْرة	Boom, surge
رَوّجَ لِ	Promote, advocate
ّمُسْتَهَل	Beginning of
على حينِ غِرّة	By surprise
تغريدة	Tweet
غَرَّدَ	To tweet
المَرّيخ	Mars
الزَهرة	Venus
عُطارِد	Mercury
المشتري	Jupiter
زحل	Saturn
اشكالي	Problematic
مُسْتَنَد -ات	Document
مِلَفّ -ات	File
تقويض	Undermining, erosion
لعاب	Saliva
مُثْمِر	Productive (Syn منتج)
اشاعات	Rumours (Also شائعات)
خامِل	Dormant, inert, passive
زي رسمي	Uniform
اَوْشَكَ	Be about to
بُقْعة	Stain
نِسْوِيّة	Feminism
مُصَلّى	Prayer hall
اهمال	Neglect
قطيع	Pack (of animals)
مُعْدي	Contagious
تِلقائي	Automatic
إلْتقط	Capture, catch
حَكّ	To scratch
حوط, حيطان	Whale
تَراكُم	Accumulation
مَرْموق	Regarded, notable (رمق = to regard)
تصريح امني	Security clearance
اقتراض	Borrow (money)
توفير المال	Saving (up) money
املس	Sleek, smooth
مجعّد	Curly
نَبْرة	Voice, tone
متقاعد	Pensioner, retiree
انقراض	Extinction
دَشَّنَ	Launch, inaugurate
تعزير	Strengthening, promoting
مدبغة	Tannery
التقط	Detect
انفصام	Disconnect
فجوة	Gap, divide
مزيج	Mix, amalgam
مزج	To mix
الحِس الفُكاهي	Sense of humour Also حس الفكاهة
تقليص	Shrinking, making smaller
سرطان الثدي	Breast cancer
مبيض, مبايض	Ovary
تَعَسُّفي	Arbitrary
مكفوف	Blind
إباحي	Pornographic, erotic
قُمامة	Rubbish, trash
قَمْل	Louse, lice (collective; sg -ة)
